GGGGGGGGGGGGGGGGGGGGGGGGGGGGGGGGGGGGGGGGGGGGGGGGG
WWWWWWWWWGWWWWWWWWWWWWGWWWWWWWWWWWGWWWWWWWWWWWWWG
WWWWWWWGGGWWWWWGGGGGGGGGGGGGWWWWWGGGGGGGWWWWWWWWG
GGGGGGGGWGWWWWWWWWWGWWGWWWWGWWGGGGWWWWWGGGGGGGGWG
GWWWWWWWWGWWWWWGGGGGWWGWWWWGWWGWWWWWWWWWWWWWWWGWG
GGGGGGGGWGWWWGGGWWWWWWGGGGWGWWGGGGGGGGGWWGGGGGGWG
WWWWWWWGWGWGGGWWWWWWWWWWWGWGWWWWWWWWWWWWWGWWWWWWG
GGGGGGGGWGWGWWWWWGGGGGGGGGWGGGGGGGGGGGGGWGWWWWWWG
WWWWWWWWWGGGGGGGWWGWWWWWWWWWWWWWWWWWWWWWWWWWWWWWG
WWWWWWWWWWWWWWWGGWGWWWWWWWWWWWWWWWWWWWWWWWWWWWWWG
WWWGGGGGGGGGGGGGGWGWWWWWWWWWWWWWWWWWWWWWWWWWWWWWG
WWGGWWWWWWWWWWWWWWGWWWWWWWWWWWWWWWWWWWWWWWWWWWWWG
GGGWWWWWWWWWWWWWWWGGGGGGGGGGGGGGGGGGGGGGGGGGGGGWG
GWWWWWWWWWWWWWWWWWWWWWWWWWWWWWWWWWWWWWWWWWWWWWGWG
GGGGGGGGGGGGGGGGGGGGGGGGGGGGGGGGGGGGGGGGGGGGGGWWG
WWWWWWWWWWWWWWWWWWWWWWWWWWWWWWWWWWWWWWWWWWWWWWWWG
WWWWWWWWWWWWWWWWWWWWWWWWWWWWWWWWWWWWWWWWWWWWWWWWX