GWWGGGGGWGGWGWWWWWWWWWW
GWWGWWWGGGWGGGWWWWWWWWW
GWWGGGGWWWWGWGWWWWWWWWW
GWWGWWWGGWGGWGWWWWWWWWW
GGGGGGGGWGGWGGWWWWWWWWW
GWWGWWWWWGWWGWWWWWWWWWW
GWWGGGGGWGWWGWWWWWWWWWW
GGWGWWWGGGWXGWWWWWWWWWW