GGGGGGGGGWWWGGGGGWWWWWWGWWWWWWWWWGWWWWWWWWGGGGGWWW
WWWWGWWWWWWGWWWWGGWWWWGGGWWWWWWWGGGWWWWWWGGWWWGGWW
WWWWGWWWWWWGGWWWWWWWWGGWGGWWWWWGGWGGWWWWGGWWWWWGGW
WWWWGWWWWWWWGGGGGGWWGGWWWGGWWWGGWWWGGWWGGWWWWWWWWW
WWWWGWWWWWWWWWWWWGWGGGGGGGGGWGGGGGGGGGWWGGWWWWWWWW
WWWWGWWWWWGGGWWWGGGGWWWWWWWGGGWWWWWWWGGWGGGWWWWGGW
GGGGGGGGGGGWGGGGGWGWWWWWWWWWGGWWWWWWWWGGGWGGGGGWWW
WWWWWWWWWWWWWWWWWWWWWWWWWWWWWWWWWWWWWWWWWWWWWWGWWW
WWWWWWWWWWWWWWWWWWWWWWWWWWWWWWWWWWWWWWWWWWWWWWGWWW
WWWWWWWWWWWWWWWWWWWWWWWWWWWWWWWWWWWWWWWWWWWWWWGWWW
WWWWWWWWWWWWWWWWWWWWWWWWWWWWWWWWWWWWWWWWWWWWWWGWWW
WWWWWWWWWWWWWWWWWWWWWWWWWWWWWWWWWWWWWWWWWWWWWWGWWW
WWWWWWWWWWWWWWWWWWWWWWWWWWWWWWWWWWWWWWWWWWWWWWGWWW
WWWWWWWWWWWWWWWWWWWWWWWWWWWWWWWWWWWWWWWWWWWWWWGWWW
WWWWWWWWWWWWWWWWWWWWWWWWWWWWWWWWWWWWWWWWWWWWWWGWWW
WWWWWWWWWWWWWWWWWWWWWWWWWWWWWWWWWWWWWWWWWWWWWWGGGX
