GGGGGGGGGGGGGGWWWGWWWWWWWWWWWWGWWWWWWWWWWWWWW
GWWWWWWWWWWWWWWWWGWWWWWWWWWWWWWWWWWWWWWWWWWWW
GWWWWWWWWWWWWWWWWGWWWWWWWWWWWWGWWWWWWWWWWWWWW
GGGGGGGGGWWWWWWWWGWWWWWWWWWWWWGWWWWWWWWWWWWWW
GWWWWWWWWWWWWWWWWGWWWWWWWWWWWWGWWWWWWWWWWWWWW
GWWWWWWWWWWWWWWWWGWWWWWWWWWWWWGWWWWWGGGGGGGGG
GGGGGGGGGGGGGGGGGGGGGGGGGGGGGGGWWWWWGWWWWWWWG
WWWWWWWWWWWWWWWWWWWWWWWWWWWWWWGWWWWWGWWWWWWWG
WWWWWWWWWWWWWWWWWWWWWWWWWWWWWWGWWWWWGWWWWWWWG
GGGGGGGGGGGGGGGGGGGGGGGGGGGGGGGGGGGGGGGGGGGWW
GWWWWWWWWWWWWWWWWWWWWWWWWWWWWWGWWWWWWWWWWWWWW
GGGGGGGGGGGGGGGGGGGGGGGGGGGWWWGWWWWWGGGGGGGGW
WWGWWWWWWWWWWWWGWWWWWWWWWWGWWWGWWWWWGWWWWWWGW
WWGWWWWWWWWWWWWGWWWWWWWWWWGWWWGWWWWWGWWWWWWGW
WWWWWWWWWWWWWWWWWWWWWWWWWWGWWWWWWWWWGWWWWWWXW
WGGGGGGGGGGGGGGGGGGGGGGGGGGGGGGGGGGGGGGGGGWWW
