GGGGGGGGGGGGGG
WWWWGWWWWWWGWG
GGGWGGGGGWWGWG
GWGWWWGWGWGGWG
XWGWGGGWGWGWWG
WGGWGWWWWWGWWG
WGWWWWGGGGGWWG
WGGGGGGWWWWGGG
