GGWWWWWWWWWWWW
WGGGGGGGGGGGWW
WWWWWWWWWWWGWW
WWWWGGGGGGGGWW
WGXWGWWWWWWGWW
WGWWGWWGWWWGWW
WGGGGWGGGGGGWW
WWWWWWWWWWWWWW
