GGGWWGWGGGGGGG
WWGWWGWGWWWWWG
GGGWWGWGWGGGGG
GWWWWGWGWGWWWW
GGGGGGWGWGGGGG
WWWGWWWGWWWWWG
GGGGGWWGWGGGGG
GWWWGGGGWXGGGG