GGGGGGGGGGGGGGGGGGGG
WWWWWWWWWWWWWWWWWWWG
GGGGGGGGGGGGGGGGGGWG
GWWWWWWWWWWWWWWWWGWG
GWGGGGGGGGGGGGGGWGWG
GWGWWWWWWWWWWWWGWGWG
GWGWGGGGGGGGGGWGWGWG
GWGWGWWWWWWWWGWGWGWG
GWGWGWGGGGGGWGWGWGWG
GWGWGWGWWWWGWGWGWGWG
GWGWGWGWGXWGWGWGWGWG
GWGWGWGWGWWGWGWGWGWG
GWGWGWGWGGGGWGWGWGWG
GWGWGWGWWWWWWGWGWGWG
GWGWGWGGGGGGGGWGWGWG
GWGWGWWWWWWWWWWGWGWG
GWGWGGGGGGGGGGGGWGWG
GWGWWWWWWWWWWWWWWGWG
GWGGGGGGGGGGGGGGGGWG
GWWWWWWWWWWWWWWWWWWG
GGGGGGGGGGGGGGGGGGGG