GGGGGGGGGGGGGGGGGGGGGGGGGWG
WWWWWWWWWWWWWWWWGWWWWWWWGWG
GGGGGGGGGGGGGGGGGGGGGWWWGWG
GWWWWWWGWWWWWGWWWWWGWGGGGGG
GGGGWWWGGGGGWGWWWGGGWGWWWWG
WWWGGGWGWWWGGGWWWGWWWGGGGWW
WWWWWGWWWWWGWWWWWGGGWWWWGGG
GGGGGGWGGGGGGWWWWWWGWWWWWWG
WWWGWWWGWWWWWWWGGGGGGGGGGGG
GGGGGGXWGGGGGGGGWWWWWWWWWGG
