GWWGGGGWGGGGGW
GWWWGWWWGWWWGW
GGGGGGGWGWGGGG
GWWWWWGWGWWWWG
GGGWGGGGGGGWWG
GWGWGWWWWWGWGG
GWWWWWWWGWGWGW
GGGGGGGWGGGWGX