GWWGGGGWWWWWGWWWWWGWWGGGGGGGGGGGGGGGGGGGGGGGG
GWWWWWWGGGGGGGGGGGGGGGWWWWWWGWWWWWWWWWWWWWWWW
GWWWWWWGWWWWWWWWWWWWWGWWWWWWGWWWGGGGGGGGGGGWW
GGGGGGGGGGGGGGGGGGGGGWWGGGGGGWWWGWWWWWWWWWGWW
GWGWGWWWWWWWWWWWWWWWGWWWWWWWWWWWGWWWWWWWWWGWW
GWGWGWWWWWWWGGGGGGWWGGGWGGGGGGGGGGWWWWWWWWGWW
GWGWGWGGGGGGGWWWWWWWGWWWGWWWWWWWGWWWWWGGGGGWW
GWGWGWGWWWWWGWGGGGGGGWWWGWWWWWWWWWWWWWWWWWWWW
GWGWGWGWWWWWGWGWWWWWWWWWGWWWWGGGGGGGGGGGGGGGG
GWGWGWGWWWWWGWGWGGGGGGGGGWWWWGWWWWWWWWGWWWGWW
GWGWGWGWWWWWGWWWGWWWWWWWWGGGGGWWWWWWWWGWWWGWW
GWGWGWGWWWWWGWWWGGGGGGWWWGWWWWWWWWWGGGGWWWWWW
GWGWGWGWWWWWGWWWGWWWWWWWGWWGGGGGGGGWWGGGGGGGG
GWGWGWGWWWWWGGGGGWWWWWWWWGWWGWWWWWWWWWGWWWWWG
WWGWWWGWWWWWWWWWGGGGGGGGGGWWGWWWWWWGWWGWGGWWG
WWGGGGGGGGGGGWWWWWWWWWWWWWWWGGGGGWWWWWGGGWXGG
