GGGGGGGGGGGGGGGGG
WWWWWWWWWWWWWWWWG
GGGGGGGGGGGGGGGGG
GWWWWWWWWWWWWWWWW
GGGGGGGGGGGWGGGGG
WWWGWWWWWWWWWWWWG
GGGGWGGGGGGGGGGGG
GWWGWWWWWGWWGWWWW
GGWGGGGGGGGWGGGGG
GWWWWGWWWWWWWWGWW
GGGWGGGGGGGGGWGGX
