GGGGGGGGGGGGGG
GWWGWWWWWWWWWG
GWWGGGGWGGGGGG
GWWWWWGWGWWWWW
GGGGGWGWWGGGGG
GWWWGGGGWWWGGG
GWGWWWWGGGWWXW
GGGGGGGWWGGGGG