GWWGGGGGWGGWGW
GWWGWWWGGGWGGG
GWWGGGGWWWWGWG
GWWGWWWGGWGGWG
GGGGGGGGWGGWGG
GWWGWWWWWGWWGW
GWWGGGGGWGWWGW
GGWGWWWGGGWXGW