GWWWWWWWWWWWWWWWWWWW
GGGGGGGGGGGGGGGGGGGG
WGWWWWWWWWWWWWWWWWWG
WGWWWWGGGGGGGGGGGGGG
WGWWWWGWWWWGWWWWWWWW
WGGGGGGWWWWGWWGGGGGW
WWWWWWGWWWWGWWGWGWGW
WGGGGGGGGGWGGGGWGWGW
WWWWWWWWWWWWWWWWGWGW
WGGGGGGGGGGGGGGGGWGW
WGWWWWWWWWWWWWWWWWGW
WGWWGGGGGGGGGGGWWWGW
WGWWGWWWWWWWWWGWGGGW
WGWWGWWWWWWWWWGWWWWW
WGWWGWWWGGGGGGGGGGGW
WGWWGWWWGWWGWWWWWWWW
WGGGGWWWGWWGWWWWWWWW
WWWWWWGGGWWGGGGGGGGW
WWWWWWGWWWWWWWWWWWGW
WGGGWWGGGWXGGGGGGGGW